F 125, 165, 254

C  50 , 22, 126
R 300 200
SO ./sprites/redbrick.xpm
WE ./sprites/purplestone.xpm
NO ./sprites/barrel.xpm
EA ./sprites/colorstone.xpm
S ./sprites/barrel.xpm


111111111111111111111111111111 11
1000000000000000000000000000011
100000000000000000000000000001
1N00001000000000000000000000111
10001000000000000000002000000111
10001000200020200020200020100111
10001000020200020020200220100111
100010000020000022002020201000111
100010000202000020002200201000111
10001000200020020000200020000111
1111100111111111111111111101111111111111111111111111
    1001                100000111
11111001111111111111111111011111111111111111111111
1000000000000000000000000001111111
111111111111111111111111111111111111
111111111111111111111111111111111111
10000000000000000000000011
1000000000000000000000011
100000000000000000000011                    11111111
10000000000000000000011                     10010001
1111111111111111111111111111111             11111111
