C 125, 165, 254

F  25 , 0000000000000000000000000000000000000000000000163, 254
R 1280 1024
SO ./sprites/redbrick.xpm
WE ./sprites/wood.xpm
NO ./sprites/bluestone.xpm
EA ./sprites/eagle.xpm
S ./sprites/6.xpm
11111111111111111111111111111111111111111111111
10000100000001000000000000000000000000000000001
10000000000000000000000000000000000000000000001
10000000010000000110000010000000000001001100001
10020000000000001100000000000010000000110000001
10000000000000011000000000001000000001100000001
10000000000000011000000000001000000001100000001
10000000000000011000000000001000000001100000001
10000000000000011000000000001000000001100000001
10000000000000011000000000001000000001100000001
10000000000000011000000000001000000001100000001
100000000000000110000N0000000000000000000000001
10000000000000011000000000000000000000000000001
10000000000000011000000000000000000000000000001
10000000000000011000000000000000000000000000001
10000000000000011000000000000000000000000000001
10000000000000011000000000000000000000000000001
10000000000000000000000000000000000000000000011
11111111111111111111111111111111111111111111111