F 125, 165, 254

C  50 , 70, 126
R 1280 800
SO ./sprites/redbrick.xpm
WE ./sprites/purplestone.xpm
NO ./sprites/mossy.xpm
EA ./sprites/colorstone.xpm
S ./sprites/barrel.xpm
11111
10001
10001
10001
10001
10001
10001
10001
10001
10001
10001
10001
10001
10001
10001
10001
10001
10001
10001
10001
10001
10001
10001
10001
100011111111111111111111111111
100000000000000000000000000001
1N0022022222222222222200220001
100011000110001100011000110001
100011000110001100011000110001
1000111111111111111111100000011111111111111111111111111111111111111111111111111111111111111111111111111111111111111111111111111111111111
1000000000000000000000000000000000000000000000000000000000000000000000000000000000000000000000000000000000000000000000000000000000000001
1000111111111111111111111111111111111111111111111111111111111111111111111111111111111111111111111111111111111111111111111111111111111111
10001
10001
10001
10001
10001
10001
10001
11111