F 125       , 113, 000000254
C  50 , 22,        1
R  800 600
SO ./sprites/redbrick.xpm
NO ./sprites/mossy.xpm
S ./sprites/barrel.xpm.xpm
EA ./sprites/colorstone.xpm
WE ./sprites/purplestone.xpm


111111111111111111111111111111   1
122000000000000000000000000001
10W000000000000000000000000001
100000100000000000000000000011
1000100000000000000000200000011
1000100020002020002020002010011
1000100002020002002020022010011
10001000002000002200202020100011
10001000020200002000220020100011
1000100020002002000020002010011
100000000000000000000000000011
100000000000000000000000000111
10000000000000000000000000111
100000000000000000000000011
111111111111111111111111111111111111
111111111111111111111111111111111111
10000000000000000000000011
1000000000000000000000011
100000000000000000000011
10000000000000000000011
111111111111111111111111111111
