 WE /home/broplz/cube3D/sprites/wood.xpm
   NO /home/broplz/cube3D/sprites/bluestone.xpm

  EA /home/broplz/cube3D/sprites/eagle.xpm
   S     /home/broplz/cube3D/sprites/pillar.xpm

     SO /home/broplz/cube3D/sprites/redbrick.xpm

 F 125,125,  168
 C 123,124,   169
R 100  10

1111111111111
1N10000000001
1000000000001
1020202020201
1111111111111

1111111
1000001
1111111