

           C        125    ,  255   ,    66

F  125   ,   0000000000000000000000000000000000000000000000123  ,  169
R               4200000001    000004123828311
     SO /home/broplz/cube3D/sprites/redbrick.xpm
 WE /home/broplz/cube3D/sprites/wood.xpm
   NO /home/broplz/cube3D/sprites/bluestone.xpm

  EA       /home/broplz/cube3D/sprites/eagle.xpm
   S     /home/broplz/cube3D/sprites/6.xpm

   1  1 1 1 1

    11111
1111111111111
1000000000001
1010000000001
1020202020201
1111111111111
