

 F 0000000000000000000000000000000000000000125,000000000000000000000000000000000000000125,  000000000000000000000000000000000168
C  000000000000000000125, 000000000000000000000000000000000000000000123,   000000000000000000000000000169
R 00000000000000000000000000000000000000000000000100 0000000000000000000000000000000000000000000000000000000123
     SO /home/broplz/cube3D/sprites/redbrick.xpm
 WE /home/broplz/cube3D/sprites/wood.xpm
   NO /home/broplz/cube3D/sprites/bluestone.xpm

  EA       /home/broplz/cube3D/sprites/eagle.xpm
   S     /home/broplz/cube3D/sprites/pillar.xpm













1111111111111
1N10000000001
1000000000001
1020202020201
1111111111111

1111111
1000001
1111111